# LUN
5 15 6332 3041 6449 68 866 3571 6464 605 6475 1047 5430 2138 1082 6480 3985
5 4 6332 341 6432 782
5 16 6449 339 5990 6448 6454 6450 5082 1269 196 6191 457 6463 3891 6471 1505 6474

# EUR
5 8 8378 4633 8651 8764 1033 2519 9012 9065
5 3 8378 8302 8186
5 13 8378 104 4053 484 8607 6314 8824 8823 4314 8947 1201 9146 5344
5 22 8378 8342 8303 840 2273 8196 8212 8168 5080 4146 7760 4250 7491 5484 1149 7371 7416 1584 5637 7701 2446 2633
5 11 8212 6382 8432 4721 1741 8276 8779 1191 8652 2627 4606
5 4 8823 8728 8606 2515
5 5 8408 8331 8238 2122 4617

# RUS
5 12 8130 8213 2620 8451 4528 8635 8741 8840 549 9149 9080 9028
5 9 8130 8089 6182 8264 8265 217 3992 3259 1476
5 57 8089 24 7938 2058 8011 4032 8038 3327 4619 8161 8317 2939 5386 8608 8623 4098 8609 8496 8452 8399 8295 8214 3603 2942 5892 3458 4518 3552 5652 2864 8637 351 4282 2541 5861 4688 8215 6407 8041 7931 7797 7761 7828 5204 7818 3544 7782 817 7642 1262 6246 3007 7859 7727 7713 2913 7455
5 8 6246 5383 7819 7906 7959 8067 8170 5302
5 43 7642 7500 1732 4278 23 894 7375 2214 7236 7161 7199 7184 5930 7215 3710 7225 5573 2668 7011 6116 7001 2702 6973 4624 5509 7072 5285 7046 7128 3134 5488 7183 771 7382 7424 3640 7417 4975 4959 7630 800 471 7938
5 2 4032 6115
5 11 3134 7247 7358 937 3335 7533 7479 7480 6241 54 7661
5 3 3710 7306 7418
5 3 7375 7499 7622
5 6 6973 6902 6895 6859 1278 746

# GCH
5 2 8937 9049
5 19 383 1658 9238 1403 2848 9434 788 9374 9292 9182 3608 9049 9066 3120 9014 9050 717 9227 587
5 7 788 9478 2229 9694 9753 9626 9627
5 18 2229 505 3040 1028 10316 10387 1896 1881 10595 4109 10718 10814 2577 5399 11128 11239 2228 11382
5 14 1403 345 9666 9729 590 9920 9982 10078 10188 6287 10415 10516 10617 10717
5 7 10078 2242 5770 2829 1590 3678 1646
5 6 5119 12509 12547 5335 12626 12660
5 10 1646 9443 142 5981 400 9564 9664 3851 9801 9918

# AFR
4 27 1258 1782 12535 6377 1710 12327 4712 12167 3694 11960 11967 1908 750 11948 11814 11730 1595 5075 6037 2375 11413 5161 1766 11210 5338 11045 476
4 19 476 5183 107 4572 6167 306 3663 5304 10444 10314 4237 10032 9909 9787 439 4912 9680 5301 9422
4 5 9680 3390 9910 690 512
4 12 3663 6226 5817 4989 3588 10616 10533 10488 10379 10260 2580 9908
4 12 9908 9930 3107 10149 4035 4634 10197 10259 4716 3232 6180 10401

# AEM
5 17 4381 8973 1914 4292 8583 8570 1068 4752 2069 8224 8118 7977 7877 5071 1063 1432 7451
5 20 7451 1432 7467 7510 4013 4362 1145 414 7477 4059 4825 7541 511 2123 7595 7576 1343 7540 4726 2853
5 14 4381 9060 9126 5034 9040 3019 2453 9145 3266 9196 472 3739 6143 9162
5 23 9162 1605 118 3517 4063 3558 9883 9994 10112 5798 10257 10360 10472 10501 10577 10667 10731 10791 3278 2685 1050 3142 11111
5 20 11111 11176 2893 3782 11479 11569 11642 11754 11843 11903 3579 111 2930 2918 5347 2271 12648 1274 12760 5824