# LUN
5 15 6332 3041 6449 68 866 3571 6464 605 6475 1047 5430 2138 1082 6480 3985
5 4 6332 341 6432 782
5 16 6449 339 5990 6448 6454 6450 5082 1269 196 6191 457 6463 3891 6471 1505 6474

# EUR
5 8 8378 4633 8651 8764 1033 2519 9012 9065
5 3 8378 8302 8186
5 13 8378 104 4053 484 8607 6314 8824 8823 4314 8947 1201 9146 5344
5 22 8378 8342 8303 840 2273 8196 8212 8168 5080 4146 7760 4250 7491 5484 1149 7371 7416 1584 5637 7701 2446 2633
5 11 8212 6382 8432 4721 1741 8276 8779 1191 8652 2627 4606

# RUS
5 12 8130 8213 2620 8451 4528 8635 8741 8840 549 9149 9080 9028
5 9 8130 8089 6182 8264 8265 217 3992 3259 1476
5 57 8089 24 7938 2058 8011 4032 8038 3327 4619 8161 8317 2939 5386 8608 8623 4098 8609 8496 8452 8399 8295 8214 3603 2942 5892 3458 4518 3552 5652 2864 8637 351 4282 2541 5861 4688 8215 6407 8041 7931 7797 7761 7828 5204 7818 3544 7782 817 7642 1262 6246 3007 7859 7727 7713 2913 7455
5 8 6246 5383 7819 7906 7959 8067 8170 5302
5 43 7642 7500 1732 4278 23 894 7375 2214 7236 7161 7199 7184 5930 7215 3710 7225 5573 2668 7011 6116 7001 2702 6973 4624 5509 7072 5285 7046 7128 3134 5488 7183 771 7382 7424 3640 7417 4975 4959 7630 800 471 7938
5 2 4032 6115
5 11 3134 7247 7358 937 3335 7533 7479 7480 6241 54 7661
5 3 3710 7306 7418
5 3 7375 7499 7622
5 6 6973 6902 6895 6859 1278 746